10
-2 -2 -2 -2 -2 -2 -2 -2 -2 -2 -2 -2 -2 -2 -2 -2 -2 -2 -2 -2
-2  0  3 -1 -2 -2 -2  4 -2 -2 -2  2 -1 -1 -2 -1 -2 -2 -1 -2
-2 -1 -1 -1 -2 -1 -2 -1 -2 -2 -2 -1 -1 -1 -2 -1 -2 -1 -1 -2
-2 -1 -2 -1 -1 -1 -1 -1 -1 -1 -1 -1 -1 -1 -1 -1 -1 -1 -1 -2
-2 -1 -2 -2 -1 -1 -2 -1 -1 -1 -1 -1 -1 -1 -1 -1 -1 -1 -2 -2
-2 -1 -1 -1 -1 -1 -1 -1 -1 -1 -1 -1 -1 -1 -1 -1 -1 -1 -1 -2
-2 -1 -1 -1 -1 -1 -2 -2 -2 -2 -2 -1 -1 -2 -1 -2 -2 -2 -1 -2
-2 -2 -1 -1 -1 -2 -2 -1 -1 -1 -1 -1 -1 -2 -1 -2 -1 -2 -1 -2
-2 -1 -1 -1 -3 -1 -2 -1  5 -2 -1 -1 -1 -1 -1 -1 -1 -1 -1 -2
-2 -2 -2 -2 -1 -2 -2 -1 -1 -2 -2 -1 -1  6 -2 -1 -2 -2 -1 -2
-2 -2 -1 -1 -1 -1 -1 -1 -1 -2 -2 -2 -1 -1 -2 -1 -1 -1 -1 -2
-2 -1 -1 -1 -1 -2 -1 -1 -1 -2 -2 -1 -1 -1 -1 -1 -2 -1 -1 -2
-2 -1 -1 -1 -1 -2 -1 -1 -2 -1 -1 -1 -1 -1 -1 -1 -2 -1 -1 -2
-2 -1 -1 -1 -1 -1 -1 -2 -2 -1 -1 -1 -1 -1  7 -2 -2 -1 -2 -2
-2 -1 -1 -1 -1 -1 -1 -1 -1 -1 -1 -1 -1 -1 -1 -1 -1 -1 -1 -2
-2 -1 -1 -1 -1 -1 -1 -2 -2 -1 -1 -1 -1 -1 -1 -3 -1 -2 -2 -2
-2 -2 -2 -1 -1 -2 -1 -2 -1 -1 -1 -1 -1 -1 -1 -1 -1 -1 -1 -2
-2 -1 -1 -1 -1 -2 -1 -2 -2 -1 -3 -2 -2 -1 -2 -2  8  9 -2 -2
-2  1 -1 -1 -2 -2 -1 -1 -1 -1 -1 -2 -2 -2 -1 -1 -1 -1 -1 -2
-2 -2 -2 -2 -2 -2 -2 -2 -2 -2 -2 -2 -2 -2 -2 -2 -2 -2 -2 -2